XXXXXXXXXXXXXXXAX
XF           GX X
X XXXXXXXXXXXXX X
X XC           BX
XE DXXXXXXXXXXXXX
XXXH          IXX
XXXXXXXXXXXXXXJXX